XXXXXXXXXXXXXXXX
XX-----X----XXXX
XXXX-X---X----XX
XXXX-X---XXXX--X
X-XX--------X--X
X-XX--XXX--XXX-X
X--X---X----X--X
X--XXXXX--XXXX-X
X--X---X-----X-X
X------XXXX--X-X
X-XXXXXXXXX--X-X
X---X--XXXX--X-X
X-XXX---XX---X-X
X-----------XXXX
X--------XXXXX-X
XXXXXXXXXXXXXXXX
